kick player
kick player w/ ship, pony + goals
kick player w/ it's their turn

player returning to game w/ all players disconnected is host + it's their turn


Ships: 


Goal types:
	AllOf -> NoHoldsBarred ThisShipIsDelicious
	BreakShip -> Core.Goal.ItsNotEvil
	ExistsChain -> Core.Goal.SelfInsertion
	ExistsPony -> Core.Goal.PrettyPrettyPrincess
	ExistsPonyGeneric -> unused
	ExistsPonyShippedto -> Core.Goal.JustExperimenting
	ExistsShip -> Core.Goal.Pomf
	ExistsShipGeneric -> Core.Goal.BuddingCuriosity
	PlayPonies -> Core.Goal.HehPeasants
	PlayShips -> Core.Goal.Quite
	PlayShipCards -> Core.Goal.Epidemic
	ShippedWithOppositeGenderedSelf -> Core.Goal.BuddingCuriosity
	ShippedWith2Versions -> Core.Goal.ItsNotExactlyCheating
	SwapCount -> Core.Goal.HoldOnINeedToMakeAFlowChart

Speical Ship Actions
	genderChange -> Core.Ship.CanITellYouASecret
	raceChange -> Core.Ship.CultMeeting
	timelineChange -> Core.Ship.DoYouThinkLoveCanBloomEvenOnABattlefield
	makePrincess -> Core.Ship.YerAPrincessHarry
	keywordChange -> EC.Ship.BlindDate
	clone -> EC.Ship.BodyDouble
	raceGenderChange -> HorriblePeople.GraciousGivers.Ship.DunkedInTheDatingPool
	addKeywords(Object) -> HorriblePeople.2015ConExclusives.Ship.ObjectofAdoration

Special Pony Actions
	exchangeCardsBetweenHands -> NoHoldsBarred.Pony.Abarenbou
	ChangelingNoRedisguise(replace) -> NoHoldsBarred.Pony.KingVespid
	ChangelingNoRedisguise(plushling) -> NoHoldsBarred.Pony.Plushling
	Changeling(nonAlicornFemale) -> NoHoldsBarred.Pony.Sleight
	ship -> NoHoldsBarred.Pony.ImpyThree
	fullCopy -> NoHoldsBarred.Pony.PixelPrism
	*hardcoded* -> HorriblePeople.2015Workshop.Pony.AlicornBigMacintosh
	interrupt -> HorriblePeople.2015Workshop.Pony.ShiaLeBeouffalo
	shipWithEverypony -> HorriblePeople.GraciousGivers.Pony.PrincessCelestAI
Other Special
	changeGoalPointValues true -> HorriblePeople.2015ConExclusives.Pony.MistressOfEqualityStarlightGlimmer

Normal abilities, but ridiculous
	count 10 -> HorriblePeople.2015ConExclusives.Pony.AnEntireSwarmOfBreezies
	race earth/unicorn -> NoHoldsBarred.Pony.RubyBlossom



